100
MMMMMMMMMMMMMMMMMMMMMMMMMMMMMMMMMMMMMMMMMMMMMMMMMMMMMMMMMMMMMMMMMMMMMMMMMMMMMMMMMMMMMMMMMMMMMMMMMMMM
MMMMMMMMMMMMMMMMMMMMMMMMMMMMMMMMMMMMMMMMMMMMMMMMMMMMMMMMMMMMMMMMMMMMMMMMMMMMMMMMMMMMMMMMMMMMMMMMMMMM
MMMMMMMMMMMMMMMMMMMMMMMMMMMMMMMMNNMMMMMMMMMMMMMMMMMMMMNMMMMMMMMMMMMMMMMMMMMMMMMMMMMMMMMMMMMMMMMMMMMM
MMMMMMMMMMMMMMMMMMMMMMMMMMMMMM$$$7$$Z$7777777777$$7$$7I77$$ZMMMMMMN8DNMMMMMMMMMMMMMMMMMMMMMMMMMMMMMM
MMMMMMMMMMMMMMMMMMMMMMMMMMMMMD$$77IIIIII??I?II????III?I7I7$$8DMMMM$$$$88DNNDDDNNMMMMMMMMMMMMMMMMMMMM
MMMMMMMMMMMMMMMMMMMMMM8NMMMMMZ$7$$77I???IIIIII??++++??I77$77777$ODO$ZZ8DD8OZZDNNNMMMMMMMMMMMMMMMMMMM
MMMMMMMMMMMMMMMMMMMMNDO$$$7MNZZ$$77IIIII777II??+++?+??I7IIII7$$OOODDZ$$$Z$$Z88DDNNMMMMMMMMMMMMMMMMMM
MMMMMMMMMMMMMMDDDD8O888OZ$$7$$$Z$777777$77IIII?+???????I7I7$7777$Z8D8O888Z$ZOODNNNMMMMMMMMMMMMMMMMMM
MMMMMMMMMMMMM8$$$Z$$ZO8OZ$$$77$$$ZZ$$$$$$$77IIIIIIII???I77$$O$ZO$ZODNNDD8ZO8NNNMNNMMMMMMMMMMMMMMMMMM
MMMMMMMMMMMN8$777$$$ZO8OZ$$77777$$$$$7777777777II???????I7I7$OOOD8O88DNNDOOD88DDDNMMMMMMMMMNNMMMMMMM
MMMMMMMMMDO$77III77$ZO8OZ$$$$7II77$777III7I?II???????I7$77$$OO$OZ$$$ZZ8NNND88DDDDNMMMMMMMMNNNMMMMMMM
MMMMMMMMM8Z$7IIII77$ZZOZ$$777$7III77III????++??++++???II7$$$$77$77$$$OODMMDDNDNNNMMMMMMMMMMMNNMMMMMM
MMMMMMMMMD777IIIII7777ZOZ$$777II?II77I?++++==++++++?7III777777$ZZ$$$$$Z8NNMMNNNNMMMMMMMMNNNMMNMMMMMM
MMMMMMMND$77II????II7$$$ZZ$$$77I7IIIII?+++===+++++++I777I?III77$$OD8$$O8DNNNMMMMMMMMMMMMNNNNMMMMMMMM
MMMMMMMMO$II??????II7777$ZZZZZ$$77II??????+++??III??II7$777I7$77$Z8DD88NNDDNMMMMMMMMMMMMNNDDNNMMMMMM
MMMMMMMDZ$I?II??????II77$$$$$$Z$$7IIII?I??++???II7II777$Z$7I7$77Z8888DDDDNMMMMMMMNNMMMMMNNDDDDDMMMMM
MMMMMMDOZ77IIII???????I77Z$777$$$$$7777II??????I77$$$77$8$77I77$$$$ZO8DDDNNMMMNDDDNMNNMMMMNDDDDMMMMM
MMMMMMNO$7$$77II??????I7$$7$777$$$$$$$77II?+++???I777$ZOO888$7ZZ$OD888DDDNMMMND8O8DNNDNNMMMNDDDMMMMM
MMMMMNDOZZOZZZ7II????I77$7777I77777$$7777I???+++?I77$$7$ZOZODDNNN88DNDDNMMMMMDDD8DNNNDDNNNMMNDNMMMMM
MMMMMN8888D8OZ$II????II77777IIII7III777777II????I7$777$ZZ$77Z88D88DDNNNNMMMMM8OOZO8DNDDDNNNNMNNMMMMM
MMMMNNNDDD88$$7III????I7$7I7II??IIIIIII??II?????I7I??I$77$7$$$ZO$$OZ8DDNNNMMNDZ$$Z8DND88DDNNNNMMMMMM
MMMMNNNNNND8O$77777I??I777II??+++??I??+???II?++++???I7I????II77777$ZZO8DNDNMND8OZ$ZODDO8DDNNMMMMMMMM
MMMMMNNNNN8OZ$$$Z$77?III77I?????+????+++??+???+++++?III?I77$7$$777ZZZO8DDDMMND88Z$$ZDOOO8DDNMMMMMMMM
MMMMMNNNNN8OO8Z$$$$7??I??I?+??III??+++???++++=======+?777I$7$$O8$O8DNDD88NNNND88O$Z8O$$O888NNMMMMMMM
MMMMNNNNNDDD88Z$77III??++??+?III777???II?I++==~~==~:~+????III7$Z8DD8ZODNNNND8DDZ$$ZOOZZO8888NMMMMMMM
MMMMMNNNNNNNDD8Z77777I?+++??IIII$777II77II??+===+=~~=++???7I$$ZZZO88DDNNNND8OO88$$$O$77$$Z8DNNMMMMMM
MMMMMMNNNNNNDD8Z$Z$$7III??I7$$77$IIIII7$II7???+=+?+ ~II?II$$777$ZO8OO8NNDDDD8OZZO$$O$$7$ZO8DO8NMMMMM
MMMMMMNNNNNNDD8OZ$77III7?IIII77$$7II77$$77III?++?I???IZZ$$ZZ$$$ZO88DNNNND8OOOO$$$$$$$777$ZZOZZ8MMMMM
MMMMMMMNNNNNDD88ZZZ$7$$77$7777$Z$7I7$$$$$777?++?I7II$ODD88OO$$ZO8DDDDDNN8OZZ$$Z$77$$$7I7$77$ZONMMMMM
MMMMNNNMMMMNNNDDD8Z$ZZ7I7$$$77$$$$$$$$$$$$$7?++?7$7I78MMM88$$$OOOZZODNDDD8OZ$$$$77II77I7$$$$O8MMMMMM
MMMMMNNNNMMMNNNND8OZ$$$77$ZZ$$$ZOZZZZ$$$$$$7III7ZOO$ZNMMNMZZZOOOOOO88DD8D8OOOOZZ$$II7$77$$$$$OMMMMMM
MMMMMNNNNNNNMNNNND8OOZ$$$$ZO$ZZO8OOOZO$$$$$$77$ZODDDDMMMMZ=+7ZOZZOOZODD888O$$$77??I7$$$$ZZZZZ8NMMMMM
MMMMMNNNNNNNMNMNNDDD888OO8D88D8OOO88OO$$$7$777$ZO8DNNNMMZ=:~?$$$$ZOZ8DD8O8OOZZ$$7I?I77$$ZZZOO8MMMMMM
MMMMMNNNNNNNMMNNNNNNNNMMNNN8OO$$$$ZZ$$$$7777III7ZO8DMMMMM8I+?I77$Z88ZOO8OOOZ$$$7I??I77$$$$$ZZOMMMMMM
MMMMMNNNNNNNNNNDZ$$ZOODDN8O$$$$$$$$$$$$$77III?I7$Z8DNNMMMNZ7I?I7ZO8OZZO8OZZ$7I777??I7$$$I7$$ZDMMMMMM
MMMMMNNNNNNNNDZZONMMMMMMND$$77$$$$$$$$7777?++???I$888DNNMN8$?=+I$OOOOZO8ZZZZ$7I??+??II77??I$ONMMMMMM
MMMMMMNNNNNNDDNMMMMMMMMMDOZ$$$$$7$$$$$777I?++++?I$O888DNNNDO$II7ZZZZZOOOOOZ$7$77I?+++II???I7OMMMMMMM
MMMMMMNNNDDDNMMMMMMMMMMMDZ$$$Z$$$77$Z$$$7I??==+I7$Z888DDDNDDOZZZ$$$$ZZOOOOZ$7III7?+++?=+I7$OMMMMMMMM
MMMMMMNNNDNMMMMMMMMMMMNDO$$$$$$$7777$O$$77?+++III7ZO8888888D8OZ77777$ZZZOOZ$77I????++==?777$DMMMMMMM
MMMMMMNNNNMMMMMMMMMMMNDO$$$$$$$777777$Z$7IIII?++?7$ZO8888DDDOZ$7IIII77$$Z$$7III?I77I?++?77$DMMMMMMMM
MMMMMMMMMMMMMMMMMMMMN8Z$$$$$$$$$77777$$77III?III$77$ZZO88D8OZ$$7777II77$$$$7$7777$7III7IZNMMMMMMMMMM
MMMMMMMMMMMMMMMMMMMN8Z$$$$$$$$77I77777$77777II7$$$$ZZ$ZOOOOO$$7$$7$77$$$$$$$$$7$$ZZ8DO88MMMMMMMMMMMM
MMMMMMMMMMMMMMMMMMNDOZ$$ZO$$$777777777$7$$$$$$$ZZOOOZ$$$$$$Z777$$$$ZOOOZZOOZ8Z$$8NNMMMMMMMMMMMMMMMMM
MMMMMMMMMMMMMMMMMMNDD8OOOOZ$$$$777I777$$77$$$O8DDDD8OO$II777I777III7$$$ODNNDN8DDMMMMMMMMMMMMMMMMMMMM
MMMMMMMMMMMMMMMMMMMMMMD8ZZZ7777777777$$77777$$8DDDDDOZ7???I???+???I7$$ZZDNMMMMMMMMMMMMMMMMMMMMMMMMMM
MMMMMMMMMMMMMMMMMMMMMMN88O777777$77$$$7I7III7$O88D8O$7I?++?+=+?I77$$$$$$$ONMMMMMMMMMMMMMMMMMMMMMMMMM
MMMMMMMMMMMMMMMMMMMMMMD8D$$777$$$$$$$7III???I7$ZZ$$$7?+???II??I7$7$$$777$Z8NNMMMMMMMMMMMMMMMMMMMMMMM
MMMMMMMMMMMMMMMMMMMMMNNNDZ$$$$ZOOOO87I?+?++=++II7I??++??I77$$777$$$$$$ZZZO8DDDND8Z$$ZODNNNNNNNDNMMMM
MMMMMMMMMMMMMMMMMMMMMMMNNNDD8DD88D$7I???+=====+?+?+++?I77$NMM88Z$$$ZO88DD8DDDD8O$77I77$ODDNND8O8MMMM
MMMMMMMMMMMMMMMMMMMMMMMMMMMMNNDDDN$7IIIIII+++?IIII?????I$8MMMDOZ$$$O8DNMMMNNND8O$7??I7$ODD8OZZODMMMM
MMMMMMMMMMMMMMMMMMMMMMMMMMMMMMMMMM$$$$$$$7I??II7777I???I7DOZZO$$$$$ZOODNMMMMMMNDO7??I7Z88OZZ$$ZDMMMM
MMMMMMMMMMMMMMMMMMMMMMMMMMMMMMMMMNOOO88DDDD8Z$77$7I?????$DOZZ$$$$$$$$$ODMMMMMMMMMDZZO888OO$$$$ODMMMM
MMMMMMMMMMMMMMMMMMMMMMMMMMMMMMMMMDNNMMMMMMMMMNO$7I7I???IO8OZ77$7II777$Z8MMMMMMMMMMNDDOOOZZ$$$$ZNMMMM
MMMMMMMMMMMMMMMMMMMMMMMMMMMMMMMN8DNMMMMMMMMMMM8$7I??++?I$O77I?IIII77$$$ZMMMMMMMMMMMN8OZZ$$$$$ZDMMMMM
MMMMMMMMMMMMMMMMMMMMMMMNNNMMMMNDDDNMMMMMMMMMMN8Z7II?++?7D77II?I??I77$$Z8MMMMMMMMMMMN8Z$$Z$$$$ZNMMMMM
MMMMMMMMMMMMMMMMMMMMMMMMNNMMMMMMMMMMMMMMMMMMMMD8O$ZDMMNNND$Z7I??I77$$ZOONMMMMMMMMMMND88OOOZODMMMMMMM
MMMMMMMMMMMMMMMMMMMMMMMMMMMMMMMMMMMMMMMMMMMMMMMMMMMMMMMMMMM8Z$77$OODDDDNMMMMMMMMMMMMMMMNDD8NMMMMMMMM
MMMMMMMMMMMMMMMMMMMMMMMMMMMMMMMMMMMMMMMMMMMMMMMMMMMMMMMMMMMMMMMNMMMMMMMMMMMMMMMMMMMMMMMMMMMMMMMMMMMM
MMMMMMMMMMMMMMMMMMMMMMMMMMMMMMMMMMMMMMMMMMMMMMMMMMMMMMMMMMMMMMMMMMMMMMMMMMMMMMMMMMMMMMMMMMMMMMMMMMMM
MMMMMMMMMMMMMMMMMMMMMMMMMMMMMMMMMMMMMMMMMMMMMMMMMMMMMMMMMMMMMMMMMMMMMMMMMMMMMMMMMMMMMMMMMMMMMMMMMMMM
MMMMMMMMMMMMMMMMMMMMMMMMMMMMMMMMMMMMMMMMMMMMMMMMMMMMMMMMMMMMMMMMMMMMMMMMMMMMMMMMMMMMMMMMMMMMMMMMMMMM
MMMMMMMMMMMMMMMMMMMMMMMMMMMMMMMMMMMMMMMMMMMMMMMMMMMMMMMMMMMMMMMMMMMMMMMMMMMMMMMMMMMMMMMMMMMMMMMMMMMM
MMMMMMMMMMMMMMMMMMMMMMMMMMMMMMMMMMMMMMMMMMMMMMMMMMMMMMMMMMMMMMMMMMMMMMMMMMMMMMMMMMMMMMMMMMMMMMMMMMMM
MMMMMMMMMMMMMMMMMMMMMMMMMMMMMMMMMMMMMMMMMMMMMMMMMMMMMMMMMMMMMMMMMMMMMMMMMMMMMMMMMMMMMMMMMMMMMMMMMMMM
MMMMMMMMMMMMMMMMMMMMMMMMMMMMMMMMMMMMMMMMMMMMMMMMMMMMMMMMMMMMMMMMMMMMMMMMMMMMMMMMMMMMMMMMMMMMMMMMMMMM
MMMMMMMMMMMMMMMMMMMMMMMMMMMMMMMMMMMMMMMMMMMMMMMMMMMMMMMMMMMMMMMMMMMMMMMMMMMMMMMMMMMMMMMMMMMMMMMMMMMM
MMMMMMMMMMMMMMMMMMMMMMMMMMMMMMMMMMMMMMMMMMMMMMMMMMMMMMMMMMMMMMMMMMMMMMMMMMMMMMMMMMMMMMMMMMMMMMMMMMMM
MMMMMMMMMMMMMMMMMMMMMMMMMMMMMMMMMMMMMMMMMMMMMMMMMMMMMMMMMMMMMMMMMMMMMMMMMMMMMMMMMMMMMMMMMMMMMMMMMMMM
MMMMMMMMMMMMMMMMMMMMMMMMMMMMMMMMMMMMMMMMMMMMMMMMMMMMMMMMMMMMMMMMMMMMMMMMMMMMMMMMMMMMMMMMMMMMMMMMMMMM
MMMMMMMMMMMMMMMMMMMMMMMMMMMMMMMMMMMMMMMMMMMMMMMMMMMMMMMMMMMMMMMMMMMMMMMMMMMMMMMMMMMMMMMMMMMMMMMMMMMM
MMMMMMMMMMMMMMMMMMMMMMMMMMMMMMMMMMMMMMMMMMMMMMMMMMMMMMMMMMMMMMMMMMMMMMMMMMMMMMMMMMMMMMMMMMMMMMMMMMMM
MMMMMMMMMMMMMMMMMMMMMMMMMMMMMMMMMMMMMMMMMMMMMMMMMMMMMMMMMMMMMMMMMMMMMMMMMMMMMMMMMMMMMMMMMMMMMMMMMMMM
MMMMMMMMMMMMMMMMMMMMMMMMMMMMMMMMMMMMMMMMMMMMMMMMMMMMMMMMMMMMMMMMMMMMMMMMMMMMMMMMMMMMMMMMMMMMMMMMMMMM
MMMMMMMMMMMMMMMMMMMMMMMMMMMMMMMMMMMMMMMMMMMMMMMMMMMMMMMMMMMMMMMMMMMMMMMMMMMMMMMMMMMMMMMMMMMMMMMMMMMM
MMMMMMMMMMMMMMMMMMMMMMMMMMMMMMMMMMMMMMMMMMMMMMMMMMMMMMMMMMMMMMMMMMMMMMMMMMMMMMMMMMMMMMMMMMMMMMMMMMMM
MMMMMMMMMMMMMMMMMMMMMMMMMMMMMMMMMMMMMMMMMMMMMMMMMMMMMMMMMMMMMMMMMMMMMMMMMMMMMMMMMMMMMMMMMMMMMMMMMMMM
MMMMMMMMMMMMMMMMMMMMMMMMMMMMMMMMMMMMMMMMMMMMMMMMMMMMMMMMMMMMMMMMMMMMMMMMMMMMMMMMMMMMMMMMMMMMMMMMMMMM
MMMMMMMMMMMMMMMMMMMMMMMMMMMMMMMMMMMMMMMMMMMMMMMMMMMMMMMMMMMMMMMMMMMMMMMMMMMMMMMMMMMMMMMMMMMMMMMMMMMM
MMMMMMMMMMMMMMMMMMMMMMMMMMMMMMMMMMMMMMMMMMMMMMMMMMMMMMMMMMMMMMMMMMMMMMMMMMMMMMMMMMMMMMMMMMMMMMMMMMMM
MMMMMMMMMMMMMMMMMMMMMMMMMMMMMMMMMMMMMMMMMMMMMMMMMMMMMMMMMMMMMMMMMMMMMMMMMMMMMMMMMMMMMMMMMMMMMMMMMMMM
MMMMMMMMMMMMMMMMMMMMMMMMMMMMMMMMMMMMMMMMMMMMMMMMMMMMMMMMMMMMMMMMMMMMMMMMMMMMMMMMMMMMMMMMMMMMMMMMMMMM
MMMMMMMMMMMMMMMMMMMMMMMMMMMMMMMMMMMMMMMMMMMMMMMMMMMMMMMMMMMMMMMMMMMMMMMMMMMMMMMMMMMMMMMMMMMMMMMMMMMM
MMMMMMMMMMMMMMMMMMMMMMMMMMMMMMMMMMMMMMMMMMMMMMMMMMMMMMMMMMMMMMMMMMMMMMMMMMMMMMMMMMMMMMMMMMMMMMMMMMMM
MMMMMMMMMMMMMMMMMMMMMMMMMMMMMMMMMMMMMMMMMMMMMMMMMMMMMMMMMMMMMMMMMMMMMMMMMMMMMMMMMMMMMMMMMMMMMMMMMMMM
MMMMMMMMMMMMMMMMMMMMMMMMMMMMMMMMMMMMMMMMMMMMMMMMMMMMMMMMMMMMMMMMMMMMMMMMMMMMMMMMMMMMMMMMMMMMMMMMMMMM
MMMMMMMMMMMMMMMMMMMMMMMMMMMMMMMMMMMMMMMMMMMMMMMMMMMMMMMMMMMMMMMMMMMMMMMMMMMMMMMMMMMMMMMMMMMMMMMMMMMM
MMMMMMMMMMMMMMMMMMMMMMMMMMMMMMMMMMMMMMMMMMMMMMMMMMMMMMMMMMMMMMMMMMMMMMMMMMMMMMMMMMMMMMMMMMMMMMMMMMMM
MMMMMMMMMMMMMMMMMMMMMMMMMMMMMMMMMMMMMMMMMMMMMMMMMMMMMMMMMMMMMMMMMMMMMMMMMMMMMMMMMMMMMMMMMMMMMMMMMMMM
MMMMMMMMMMMMMMMMMMMMMMMMMMMMMMMMMMMMMMMMMMMMMMMMMMMMMMMMMMMMMMMMMMMMMMMMMMMMMMMMMMMMMMMMMMMMMMMMMMMM
MMMMMMMMMMMMMMMMMMMMMMMMMMMMMMMMMMMMMMMMMMMMMMMMMMMMMMMMMMMMMMMMMMMMMMMMMMMMMMMMMMMMMMMMMMMMMMMMMMMM
MMMMMMMMMMMMMMMMMMMMMMMMMMMMMMMMMMMMMMMMMMMMMMMMMMMMMMMMMMMMMMMMMMMMMMMMMMMMMMMMMMMMMMMMMMMMMMMMMMMM
MMMMMMMMMMMMMMMMMMMMMMMMMMMMMMMMMMMMMMMMMMMMMMMMMMMMMMMMMMMMMMMMMMMMMMMMMMMMMMMMMMMMMMMMMMMMMMMMMMMM
MMMMMMMMMMMMMMMMMMMMMMMMMMMMMMMMMMMMMMMMMMMMMMMMMMMMMMMMMMMMMMMMMMMMMMMMMMMMMMMMMMMMMMMMMMMMMMMMMMMM
MMMMMMMMMMMMMMMMMMMMMMMMMMMMMMMMMMMMMMMMMMMMMMMMMMMMMMMMMMMMMMMMMMMMMMMMMMMMMMMMMMMMMMMMMMMMMMMMMMMM
MMMMMMMMMMMMMMMMMMMMMMMMMMMMMMMMMMMMMMMMMMMMMMMMMMMMMMMMMMMMMMMMMMMMMMMMMMMMMMMMMMMMMMMMMMMMMMMMMMMM
MMMMMMMMMMMMMMMMMMMMMMMMMMMMMMMMMMMMMMMMMMMMMMMMMMMMMMMMMMMMMMMMMMMMMMMMMMMMMMMMMMMMMMMMMMMMMMMMMMMM
MMMMMMMMMMMMMMMMMMMMMMMMMMMMMMMMMMMMMMMMMMMMMMMMMMMMMMMMMMMMMMMMMMMMMMMMMMMMMMMMMMMMMMMMMMMMMMMMMMMM
MMMMMMMMMMMMMMMMMMMMMMMMMMMMMMMMMMMMMMMMMMMMMMMMMMMMMMMMMMMMMMMMMMMMMMMMMMMMMMMMMMMMMMMMMMMMMMMMMMMM
MMMMMMMMMMMMMMMMMMMMMMMMMMMMMMMMMMMMMMMMMMMMMMMMMMMMMMMMMMMMMMMMMMMMMMMMMMMMMMMMMMMMMMMMMMMMMMMMMMMM
MMMMMMMMMMMMMMMMMMMMMMMMMMMMMMMMMMMMMMMMMMMMMMMMMMMMMMMMMMMMMMMMMMMMMMMMMMMMMMMMMMMMMMMMMMMMMMMMMMMM